"screen_name","tweets","retweets","favorites","engagements","average"
"arXiv_Daily",36,137,342,479,13
"Deep__AI",24,106,268,374,16
"WomenWhoCode",3,86,206,292,97
"gp_pulipaka",6,141,95,236,39
"techsocialnet",63,143,92,235,4
"co_vein",36,73,52,125,3
"PlayCraftLearn",5,23,95,118,24
"RedHat",3,24,79,103,34
"iphonegalaxymd",27,66,34,100,4
"CockroachDB",2,34,64,98,49
